\char\"	char	txt
"\char\"	char	txt
bigint	int8	num
bool	bool	bit
boolean	bool	bit
bpchar	char	txt
bytea	string	txt
char	char	txt
character	char	txt
character varying	varchar	txt
date	date	date
double precision	double	num
float4	float	num
float8	double	num
inet	inet	txt
int	integer	num
int2	smallint	num
int4	integer	num
int8	bigint	num
integer	integer	num
interval	interval	date
name	varchar	txt
numeric	double	num
oid	integer	num
real	float	num
smallint	smallint	num
text	text	txt
timestamp	timestamp	date
timestamp with time zone	timestamptz	date
timestamp without time zone	timestamp	date
timestamptz	timestamptz	date
varchar	varchar	txt
cidr	cidr	txt
macaddr	macaddr	txt
serial	integer	num
bigserial	bigint	num
time	time 	date
uuid	uid	txt
regproc	txt	txt
oidvector	integer	num
hstore	txt	txt